111111111111111111111111111
1000011C00000C0000000000C11
1000C00000C11C0000E00000011
1P0000010C111101C1000C000C1
111111111111111111111111111