111111111111111111111111
1CP00000000110000E000001
111111111100000010000011
100000010001010001000001
100C00001101010001000001
10000000110101000100000100
111111111111111111111111